1110111110101010101110101011101
0010000010101010101010101010101
1110101011101111111011111110111
1000101010101010000000000000000
1011101110111010101011111111111
1010001000100000101010000000000
1011111110101011111110111111111
1000101000001010000000100000000
1111101011111110101111101111111
0010000000100000101000001000000
1111111011111011111011111011111
0000100010100010000010000010000
1111101110101110101110111111111
0010000010001000101000101000000
1111101110111011111011101110111
0010001000100010000000100000001
1110111011101110111011101110101
0010001000100010100010001000101
1110111011101110111110111010111
1000001010001000001000100010100
1110111010111010111111101111111
0010100010100010100010001010000
1111101110101111101110111011101
0010101010101000001000100000001
1110101011101110111011111110111
0010101010101010100010001000100
1110111010111010111111101011101
1000101010101000000010100010001
1110101010101010111110101110111
0010101010101010001010101010100
1110101010101011111010111011111